Abeille 			travail assidu bénévole dans une autre corporation estudiantine
Aigle germain 			Phiologie germanique
Alambic				Chimie
Alambic et fourquet		Brasserie
Ancre 				Amour de la navigation
Ane cadichon 			Blessé en guindaille
Anneaux olympiques		Education physique
* avec caducée médecine		Kinésithérapie
Appareil photo			Etudiant en photographie
Bacchus argenté 		Vice roi des bleus
Bacchus doré			Roi des bleus
Balance 			Droit
Balance et glaive 		Criminologie
Ballon et cornu 		Assistant/jobbiste en labo
Bobine				Physique
Bobine et éclairs		Ingé industriel
Bourse 				Trésorier
Bouteille de champagne		Coma éthylique prouvé
Bouteill du vin 		Amour du vin/ grosse cuite
Cadenas petit coeur		Soumis
Caducée d'Hermès		Ingénieur commercial
Caducée des médecins		Médecine
* sur lauriers			Vétérinaire
Caducée sur coupe 		Pharmacie
Caisse enregistreuse		Comptabilité
Calice 				Séminariste
Caracole 			Namurois
Globe				Géographie
Grapppe de raisin		Amour du vin / perte virginité
Grattoir et plume		Histoire de l'art archéologie
Grenouille argentée		Vice délégué de cours
Grenouille dorée		Délégué de cours/ prési de cercle
Homard 				Mène grand train de vie
Hure 				Luxembourgeois
Kangourou			Grand dragueur
Koala				S'endort en guindaille
Lampe de mineur			Carolo
Lampe de pharmacien		Infirmerie
Laurier double			Sciences économiques
Lettres HPO 			Etudiant en orientale
Lime 				Gros baiseur
Lion 				Patriote ou flamand
Livre et plume 			Amour des lettres
Livre ouvert			Théologie
Locomotive			Remplace 5 éléphant
Lyre				Amour de la musique Folklore/Chants
Lyre + Tête de mort		Très mauvais chanteur
Mains serrées			Symbole d'amitié
Manneken-pis 			Bruxellois
Marteau, compas, piolet		Ingénieur Civil
Minerve				Etudiant en histoire
Molaire 			Dentisterie
Navet 				Sodomie
Noeud de magicien		Assisant/ infirmière Sociaux
Nounours 			Gros dormeur
Carotte 			Surpris en pleine partie de jambe en l'air en guindaille
Cartes à jouer			Amour du jeu
Casque romain 			Humanités latines
Cerf 				Ardeur sexuelle
Chainette 			Marié/Fiancé(entoure la penne)
Chameau renversé 		Coeur pris
Chameau sur pieds 		Coeur à prendre
Charrue 			Agronomie
Chassis à molette 		Carolo
Chauve)souris 			Buit blance pour motif corporatiste
Cheval qui court 		Grand coureur
Chope 				Responsable bar/ serveur café
Chop 				Amour de la bière
Chouette 			Vie nocturne
Ciseaux 			Poil ouplumes
Clé 				Gardien des biens d'une corporation estudiantine
Cochon renversé         	Baptisé (calotte only)
Cochon sur patte        	Baptiseur (calotte only)
Cocote en papier        	Absences aux cours
Coq français            	Grande gueule / Français
Palette vernie          	Amour de la peinture
Palme argentée          	License
Palme dorée             	Doctorat
Palmier                 	Glandeur
Papillon                	Hâte dans les études
Périclès 			Phiologie classique
Perron liégeois		 	Légeois
Perroquet 			Pinailleur
Perroquet sur perchoir		Grande gueule qui bacarde en corona
Phi-espilon 			Mathématiques en humanité
Pi 				Mathématiques
Pic et plumes croisés 		Archéologie
Pigeon 				Voyage bcp de fac en fac
Piolets doubles et croisés 	Géologie
Plume 				Etudiant en romane
Poignard 			Grand inquisiteur
Poireau 			Surpris en pleine fellation en guindaille (jardin secret)
Poisson 			Se tape des thons à chaque guindaille
Poule 				Fille très chaude
Coq Wallon 			Wallon
Cor de chasse 			Grand chasseur devant l'éternel
Couronne argentée 		Vice président
Couronne dorée 			Président (ou étudiant à namur)
Crabe 				Lenteur dans les études
Dé à jouer 			Joueur
Djan Djan casqué 		Brabant Wallon
Doudou 				Montois
Ecureuil 			Sciences Eco à liège (ou trésorier)
Elephant à l'endroit 		Humour très lourd
Elephant à l'envers 		Humour excessivement lourd
Epée 				Jardin secret complet
Epi de blé 			Radin
Epi de blé et faucille 		Chanceux aux examens
Epsilon 			Scientifiques en humanités
Escargot 			Lenteur dans les études
Etoile argentée 		Paiment d'un minerval pr un type d'étude déjà presté (redoublement)
Etoile dorée 			Paiement d'un minerval pr un type d'étude non presté
Etoile doré sur fond bleu	Année complémentaire en langue
Etoile sur le velours 		Année dans certaines corporations
Etoile rouge 			Année d'études supérieures à l'étranger
Presse d'imprimerie 		Responsable d'un journal estudiantin
Puit à charbon 			Carolo
Rose 				Dépucelé en guindaille
Sabot 				Amour du théâtre
Saint-Michel 			Bruxellois
Sanglier 			Ardennais
Singe 				Gros blagueur
Singe du grand garde 		Montois
Soleil 				Baptisé en philo et lettres
Sou troué 			Nuit passée au poste pr motif estudiantin
Sphinx 				Polyglotte ou Traducteur
Squelette jambe fermées 	Amour anatomie masculine
Squelette jambe ouvertes 	Amour anatomie féminine
Symbole des deux sexes 		Biologie
Tambour 			Membre d'une harmonie
Téléphone 			Etudiant en communication
Tête d'aigle 			Amour de l'aviation
Tête d'indien 			Buffalo
Tête de cheval 			Vétérinaire
Tête de loup vue de face 	Centrale
Tête de loup vue de profil	Chimacienne
Tête de mort argentée 		2ème sess totale ratée
Fer à cheval 			Chanceux et seperstitieux
Feuille de vigne 		Perte de la virginité masculine en guindaille
Flambeaux entrecroisés 		Etudiant en philosophie
Flèche 				Ejaculateur précoce
Flèche et plume 		Etudiant en romane
Flèche , plume et serpent 	Etuidant en germanique
Fleur de lys 			Scout ou royaliste
Fourchette 			Fin gourmet
Fourchettes croisées 		Bouffe comme un porc
Gazelles 			Rapide à l'affond
Gielle de Binche 		Binchois
Girafe 				Grande gueule
Girage à l'endroit 		Fidèle
Girafe à l'envers 		Infidèle
Tête de mort avec fémur 	Echec total ou abandon en juin
Tête de mort dorée 		2ème sess totale réussie
Tête de mort sans fémur 	Echec total en septembre
Tête de mort sur la visière 	Guindailleur jusqu'à la mort
Tête de vache 			Deuxième session intégrale
Tomate				Surpris en train de faire une minette en guindaille
Torè 				Liégeois
Tour 				Tournaisien
Trèfle à quatre feuilles 	Chanceux
Troubadour 			Met l'ambiance en guindaille
ULG 				Etudiant à l'unif de liège + année de baptème
Valise 				Voyage bcp de fac en fac
Zéro 				Bourré avant 00h






